. . # . . . . . . .
. . # . . . . . . .
. . # . # . . . . .
. . # . # . . . . .
. . # X # . . . . .
. . # # # . # # # #
. . # . . . . . . .
. . # # # . # # # .
. . . . . . . . . .
. . . . 0 . . . . .